XXXXXXXXXXXXXXXXXXX
XS       X       SX
X        X        X
X        X        X
X        X        X
X        X        X
X        X        X
X        X        X
X        X        X
X        D       BX
X        X        X
X        X        X
X        X        X
X        X        X
X        X        X
X        X        X
X        X        X
X        X        X
XS       X       SX
XXXXXXXXXXXXXXXXXXX