XXXXXXXXXXXXXXXXXXX
XS       X       SX
X        D        X
XXDXDXDXDXXDXDXDXDX
X        D        X
X        X        X
X        D        X
X        X        X
X        D        X
X       DBD       X
X        X        X
X        D        X
X        X        X
X        D        X
X        X        X
X        D        X
XXDXDXDXDXXDXDXDXDX
X        D        X
XS       X       SX
XXXXXXXXXXXXXXXXXXX