XXXXXXXXXXXXXXXXXXX
X        B        X
X        X        X
XDDDDDDDDXDDDDDDDDX
X        X        X
X        X        X
X        X        X
X        X        X
X        X        X
X        X        X
X        X        X
X        X        X
X        X        X
X        X        X
X        X        X
X    XDXDXDXDX    X
X    X X X X X    X
X    X X X X X    X
X    XSXSXSXSX    X
XXXXXXXXXXXXXXXXXXX